111111111111111
1S0000000000001
100100000010001
101000000001001
100000000000001
100000010000001
100000000000001
111111111110111
100000000000001
111111111110111
100000000000001
111111111111111
