111111111111111
100000000000001
100100000010001
101000000001001
100000000000001
10000001  000001
100000000000001
111111111110111
100000000000001
111111111110111
100000000000001
111111111111111
