SO                         ./textures/img.xpm

NO ./textures/img.xpm
C  135,206,235

WE ./textures/img.xpm
EA ./textures/img.xpm

F 91,58,0

111111111111111
100000000000001
100100000010001
101000000001001
100000000000001
100000010000001
10000N000000001
100000000000001
100000000000001
100000000000001
100000000000001
111111111111111


