SO                         ./textures/img.xpm

NO ./textures/img.xpm
C  225,30,0
WE ./textures/img.xpm
EA ./textures/img.xpm


F        0,   85    ,  1       

1111111
      11111111111111111111111111
        1000000000110000000000001
        1011000001110000000000001
        1001000000000000000000001              111111111
        1001000000000000N00000001              11111011
        1001000000000000000000001              111111
        1111111111111111111111111
11111111 1111111 111111111111

