SO                         ./textures/img.xpm

NO ./textures/img.xpm
C  135,206,235

WE ./textures/img.xpm
EA ./textures/img.xpm

F 91,58,0

1111111111111111
100000000000001
100000000000001
100100000010001
101000000001001
100000000000001
100000N010000001
100000000000001
100000000000001
111111111110111
100000000000001
111111111111111


